name,size,reads,writes,comparisons,total
Bubble Sort,2,2,0,2,4
Bubble Sort,3,8,2,6,16
Bubble Sort,4,18,8,12,38
Bubble Sort,5,16,6,10,32
Bubble Sort,6,50,16,30,96
Bubble Sort,7,36,16,21,73
Bubble Sort,8,98,36,56,190
Bubble Sort,9,128,34,72,234
Bubble Sort,10,144,56,80,280
Bubble Sort,11,160,70,88,318
Bubble Sort,12,242,68,132,442
Bubble Sort,13,288,80,156,524
Bubble Sort,14,312,110,168,590
Bubble Sort,15,336,120,180,636
Bubble Sort,16,450,112,240,802
Bubble Sort,17,384,124,204,712
Bubble Sort,18,442,164,234,840
Bubble Sort,19,324,120,171,615
Bubble Sort,20,494,156,260,910
Bubble Sort,21,640,188,336,1164
Bubble Sort,22,840,212,440,1492
Bubble Sort,23,880,258,460,1598
Bubble Sort,24,1058,258,552,1868
Bubble Sort,25,816,314,425,1555
Bubble Sort,26,900,242,468,1610
Bubble Sort,27,1196,336,621,2153
Bubble Sort,28,1404,372,728,2504
Bubble Sort,29,1400,500,725,2625
Bubble Sort,30,1682,530,870,3082
Bubble Sort,31,1680,450,868,2998
Bubble Sort,32,1550,428,800,2778
Bubble Sort,33,1856,508,957,3321
Bubble Sort,34,1584,468,816,2868
Bubble Sort,35,1972,768,1015,3755
Bubble Sort,36,2100,662,1080,3842
Bubble Sort,37,2520,780,1295,4595
Bubble Sort,38,2738,766,1406,4910
Bubble Sort,39,2356,654,1209,4219
Bubble Sort,40,2262,712,1160,4134
Bubble Sort,41,2880,796,1476,5152
Bubble Sort,42,3198,810,1638,5646
Bubble Sort,43,2856,798,1462,5116
Bubble Sort,44,3526,910,1804,6240
Bubble Sort,45,2816,838,1440,5094
Bubble Sort,46,3330,1074,1702,6106
Bubble Sort,47,3496,946,1786,6228
Bubble Sort,48,3572,1232,1824,6628
Bubble Sort,49,3936,1182,2009,7127
Bubble Sort,50,3920,1076,2000,6996
Bubble Sort,51,4600,1152,2346,8098
Bubble Sort,52,4590,1434,2340,8364
Bubble Sort,53,4784,1472,2438,8694
Bubble Sort,54,5406,1362,2754,9522
Bubble Sort,55,5508,1468,2805,9781
Bubble Sort,56,4950,1464,2520,8934
Bubble Sort,57,6272,1620,3192,11084
Bubble Sort,58,6612,1524,3364,11500
Bubble Sort,59,6612,1696,3363,11671
Bubble Sort,60,5900,1672,3000,10572
Bubble Sort,61,6480,1818,3294,11592
Bubble Sort,62,6588,1982,3348,11918
Bubble Sort,63,5456,1608,2772,9836
Bubble Sort,64,7560,2210,3840,13610
Bubble Sort,65,7168,2050,3640,12858
Bubble Sort,66,7150,2202,3630,12982
Bubble Sort,67,8316,2164,4221,14701
Bubble Sort,68,7102,2196,3604,12902
Bubble Sort,69,8568,2434,4347,15349
Bubble Sort,70,7590,2120,3850,13560
Bubble Sort,71,8820,2044,4473,15337
Bubble Sort,72,9230,2572,4680,16482
Bubble Sort,73,9216,2342,4672,16230
Bubble Sort,74,9052,2942,4588,16582
Bubble Sort,75,8880,2728,4500,16108
Bubble Sort,76,10650,2994,5396,19040
Bubble Sort,77,9880,3266,5005,18151
Bubble Sort,78,9240,2588,4680,16508
Bubble Sort,79,12168,3052,6162,21382
Bubble Sort,80,10428,3242,5280,18950
Bubble Sort,81,11840,3484,5994,21318
Bubble Sort,82,12150,3424,6150,21724
Bubble Sort,83,10168,3656,5146,18970
Bubble Sort,84,12782,3824,6468,23074
Bubble Sort,85,12768,3838,6460,23066
Bubble Sort,86,13260,3472,6708,23440
Bubble Sort,87,12040,3836,6090,21966
Bubble Sort,88,15138,4032,7656,26826
Bubble Sort,89,13024,3536,6586,23146
Bubble Sort,90,13172,3704,6660,23536
Bubble Sort,91,14040,4310,7098,25448
Bubble Sort,92,15106,4004,7636,26746
Bubble Sort,93,15272,4274,7719,27265
Bubble Sort,94,15996,4686,8084,28766
Bubble Sort,95,15228,4592,7695,27515
Bubble Sort,96,15770,4824,7968,28562
Bubble Sort,97,18240,4784,9215,32239
Bubble Sort,98,16296,4308,8232,28836
Bubble Sort,99,16856,5210,8514,30580
Bubble Sort,100,19404,4388,9800,33592
Bubble Sort,101,19000,5124,9595,33719
Bubble Sort,102,18180,5178,9180,32538
Bubble Sort,103,19176,5980,9682,34838
Bubble Sort,104,18540,5144,9360,33044
Bubble Sort,105,15600,5000,7875,28475
Bubble Sort,106,21840,5412,11024,38276
Bubble Sort,107,20776,6108,10486,37370
Bubble Sort,108,21828,6466,11016,39310
Bubble Sort,109,22680,6088,11445,40213
Bubble Sort,110,22454,6092,11330,39876
Bubble Sort,111,22660,6346,11433,40439
Bubble Sort,112,22200,6082,11200,39482
Bubble Sort,113,21280,6406,10735,38421
Bubble Sort,114,24408,6026,12312,42746
Bubble Sort,115,23028,6436,11615,41079
Bubble Sort,116,24840,6452,12528,43820
Bubble Sort,117,24592,6942,12402,43936
Bubble Sort,118,24102,6796,12154,43052
Bubble Sort,119,22184,7346,11186,40716
Bubble Sort,120,26418,7346,13320,47084
Bubble Sort,121,27360,7336,13794,48490
Bubble Sort,122,25168,7812,12688,45668
Bubble Sort,123,23668,7736,11931,43335
Bubble Sort,124,25092,7370,12648,45110
Bubble Sort,125,28768,8646,14500,51914
Bubble Sort,126,27000,7208,13608,47816
Bubble Sort,127,29736,7556,14986,52278
Bubble Sort,128,25908,7540,13056,46504
Bubble Sort,129,30720,8778,15480,54978
Bubble Sort,130,28122,8488,14170,50780
Bubble Sort,131,31980,8122,16113,56215
Bubble Sort,132,29868,8002,15048,52918
Bubble Sort,133,33528,9210,16891,59629
Bubble Sort,134,32984,8496,16616,58096
Bubble Sort,135,34304,8630,17280,60214
Bubble Sort,136,34020,9694,17136,60850
Bubble Sort,137,33184,9102,16714,59000
Bubble Sort,138,33428,9300,16836,59564
Bubble Sort,139,31740,10452,15985,58177
Bubble Sort,140,33916,9246,17080,60242
Bubble Sort,141,36120,9870,18189,64179
Bubble Sort,142,31584,9602,15904,57090
Bubble Sort,143,30956,8468,15587,55011
Bubble Sort,144,37180,9408,18720,65308
Bubble Sort,145,39744,10304,20010,70058
Bubble Sort,146,39440,10740,19856,70036
Bubble Sort,147,40004,12866,20139,73009
Bubble Sort,148,38220,10746,19240,68206
Bubble Sort,149,41736,10972,21009,73717
Bubble Sort,150,43210,10728,21750,75688
Bubble Sort,151,39600,10752,19932,70284
Bubble Sort,152,44696,11642,22496,78834
Bubble Sort,153,41040,11190,20655,72885
Bubble Sort,154,44982,11770,22638,79390
Bubble Sort,155,44660,13014,22475,80149
Bubble Sort,156,44950,11208,22620,78778
Bubble Sort,157,42744,12072,21509,76325
Bubble Sort,158,48670,12600,24490,85760
Bubble Sort,159,45188,12460,22737,80385
Bubble Sort,160,49926,12656,25120,87702
Bubble Sort,161,46080,12594,23184,81858
Bubble Sort,162,41538,12106,20898,74542
Bubble Sort,163,50220,13508,25265,88993
Bubble Sort,164,48574,12236,24436,85246
Bubble Sort,165,48216,13124,24255,85595
Bubble Sort,166,51810,14488,26062,92360
Bubble Sort,167,51128,13796,25718,90642
Bubble Sort,168,54776,14856,27552,97184
Bubble Sort,169,52416,14036,26364,92816
Bubble Sort,170,49010,14830,24650,88490
Bubble Sort,171,56100,14792,28215,99107
Bubble Sort,172,57114,13772,28724,99610
Bubble Sort,173,55040,15788,27680,98508
Bubble Sort,174,50516,15136,25404,91056
Bubble Sort,175,55680,15392,28000,99072
Bubble Sort,176,53200,16062,26752,96014
Bubble Sort,177,55968,14808,28143,98919
Bubble Sort,178,59118,14822,29726,103666
Bubble Sort,179,60164,16592,30251,107007
Bubble Sort,180,59786,16066,30060,105912
Bubble Sort,181,61560,16624,30951,109135
Bubble Sort,182,61902,17800,31122,110824
Bubble Sort,183,56056,16540,28182,100778
Bubble Sort,184,63318,16904,31832,112054
Bubble Sort,185,65872,16730,33115,115717
Bubble Sort,186,58830,16992,29574,105396
Bubble Sort,187,65100,17276,32725,115101
Bubble Sort,188,61710,16888,31020,109618
Bubble Sort,189,70312,16718,35343,122373
Bubble Sort,190,68796,18882,34580,122258
Bubble Sort,191,71440,17406,35908,124754
Bubble Sort,192,67996,19884,34176,122056
Bubble Sort,193,73728,18972,37056,129756
Bubble Sort,194,63304,18380,31816,113500
Bubble Sort,195,65960,19038,33150,118148
Bubble Sort,196,72150,18782,36260,127192
Bubble Sort,197,73696,19012,37036,129744
Bubble Sort,198,69344,18858,34848,123050
Bubble Sort,199,74844,21202,37611,133657
Bubble Sort,200,75620,20206,38000,133826
Bubble Sort,201,71600,20274,35979,127853
Bubble Sort,202,70752,20562,35552,126866
Bubble Sort,203,72720,20960,36540,130220
Bubble Sort,204,73892,19998,37128,131018
Bubble Sort,205,70992,21156,35670,127818
Bubble Sort,206,75030,21004,37698,133732
Bubble Sort,207,83224,22250,41814,147288
Bubble Sort,208,83628,22928,42016,148572
Bubble Sort,209,79872,22960,40128,142960
Bubble Sort,210,73986,21850,37170,133006
Bubble Sort,211,76860,21654,38613,137127
Bubble Sort,212,86510,24708,43460,154678
Bubble Sort,213,81832,21300,41109,144241
Bubble Sort,214,82218,24392,41302,147912
Bubble Sort,215,86884,23696,43645,154225
Bubble Sort,216,88150,21952,44280,154382
Bubble Sort,217,85968,24750,43183,153901
Bubble Sort,218,78554,22930,39458,140942
Bubble Sort,219,85020,23250,42705,150975
Bubble Sort,220,89352,23034,44880,157266
Bubble Sort,221,84920,21766,42653,149339
Bubble Sort,222,95914,22698,48174,166786
Bubble Sort,223,87912,24006,44154,156072
Bubble Sort,224,89646,25924,45024,160594
Bubble Sort,225,98112,23838,49275,171225
Bubble Sort,226,92250,25884,46330,164464
Bubble Sort,227,87688,25592,44038,157318
Bubble Sort,228,94886,26820,47652,169358
Bubble Sort,229,94392,26200,47403,167995
Bubble Sort,230,85646,24770,43010,153426
Bubble Sort,231,98440,24430,49434,172304
Bubble Sort,232,91014,26458,45704,163176
Bubble Sort,233,101152,26916,50794,178862
Bubble Sort,234,97860,27940,49140,174940
Bubble Sort,235,102024,29298,51230,182552
Bubble Sort,236,107160,26934,53808,187902
Bubble Sort,237,110448,28356,55458,194262
Bubble Sort,238,105228,27238,52836,185302
Bubble Sort,239,103768,29410,52102,185280
Bubble Sort,240,97512,28670,48960,175142
Bubble Sort,241,107040,27784,53743,188567
Bubble Sort,242,116162,27702,58322,202186
Bubble Sort,243,111804,29624,56133,197561
Bubble Sort,244,109350,29956,54900,194206
Bubble Sort,245,111752,27360,56105,195217
Bubble Sort,246,116130,31164,58302,205596
Bubble Sort,247,111192,29526,55822,196540
Bubble Sort,248,114114,31254,57288,202656
Bubble Sort,249,120032,34370,60258,214660
Bubble Sort,250,116034,29716,58250,204000
Bubble Sort,251,118000,29726,59236,206962
Bubble Sort,252,112950,33694,56700,203344
Bubble Sort,253,114408,29350,57431,201189
Bubble Sort,254,119922,30936,60198,211056
Bubble Sort,255,125476,34498,62985,222959
Bubble Sort,256,126480,31650,63488,221618
Bubble Sort,257,122368,34270,61423,218061
Bubble Sort,258,127472,31826,63984,223282
Bubble Sort,259,114036,35570,57239,206845
Bubble Sort,260,127428,31996,63960,223384
Bubble Sort,261,122200,31968,61335,215503
Bubble Sort,262,124236,33324,62356,219916
Bubble Sort,263,114232,35762,57334,207328
Bubble Sort,264,120454,34134,60456,215044
Bubble Sort,265,127776,34792,64130,226698
Bubble Sort,266,130910,36538,65702,233150
Bubble Sort,267,133000,36334,66750,236084
Bubble Sort,268,122286,35280,61372,218938
Bubble Sort,269,132392,37724,66443,236559
Bubble Sort,270,139342,34584,69930,243856
Bubble Sort,271,130140,36624,65311,232075
Bubble Sort,272,143088,38346,71808,253242
Bubble Sort,273,136000,37616,68250,241866
Bubble Sort,274,134862,35886,67678,238426
Bubble Sort,275,141384,38160,70950,250494
Bubble Sort,276,142450,35894,71484,249828
Bubble Sort,277,145728,38852,73128,257708
Bubble Sort,278,142378,41516,71446,255340
Bubble Sort,279,146784,36154,73656,256594
Bubble Sort,280,151776,41856,76160,269792
Bubble Sort,281,142240,38508,71374,252122
Bubble Sort,282,147806,37488,74166,259460
Bubble Sort,283,155100,41468,77825,274393
Bubble Sort,284,147726,41374,74124,263224
Bubble Sort,285,154496,39992,77520,272008
Bubble Sort,286,153330,39632,76934,269896
Bubble Sort,287,152724,39732,76629,269085
Bubble Sort,288,149814,41990,75168,266972
Bubble Sort,289,162432,42552,81498,286482
Bubble Sort,290,162418,42054,81490,285962
Bubble Sort,291,159500,39202,80025,278727
Bubble Sort,292,151320,42618,75920,269858
Bubble Sort,293,160600,44950,80575,286125
Bubble Sort,294,169940,42094,85260,297294
Bubble Sort,295,170520,39880,85550,295950
Bubble Sort,296,169920,44636,85248,299804
Bubble Sort,297,163392,40740,81972,286104
Bubble Sort,298,162756,44978,81652,289386
Bubble Sort,299,166880,46728,83720,297328
Bubble Sort,300,170430,44166,85500,300096
Selection Sort,2,5,4,3,12
Selection Sort,3,9,6,6,21
Selection Sort,4,14,8,10,32
Selection Sort,5,20,10,15,45
Selection Sort,6,27,12,21,60
Selection Sort,7,35,14,28,77
Selection Sort,8,44,16,36,96
Selection Sort,9,54,18,45,117
Selection Sort,10,65,20,55,140
Selection Sort,11,77,22,66,165
Selection Sort,12,90,24,78,192
Selection Sort,13,104,26,91,221
Selection Sort,14,119,28,105,252
Selection Sort,15,135,30,120,285
Selection Sort,16,152,32,136,320
Selection Sort,17,170,34,153,357
Selection Sort,18,189,36,171,396
Selection Sort,19,209,38,190,437
Selection Sort,20,230,40,210,480
Selection Sort,21,252,42,231,525
Selection Sort,22,275,44,253,572
Selection Sort,23,299,46,276,621
Selection Sort,24,324,48,300,672
Selection Sort,25,350,50,325,725
Selection Sort,26,377,52,351,780
Selection Sort,27,405,54,378,837
Selection Sort,28,434,56,406,896
Selection Sort,29,464,58,435,957
Selection Sort,30,495,60,465,1020
Selection Sort,31,527,62,496,1085
Selection Sort,32,560,64,528,1152
Selection Sort,33,594,66,561,1221
Selection Sort,34,629,68,595,1292
Selection Sort,35,665,70,630,1365
Selection Sort,36,702,72,666,1440
Selection Sort,37,740,74,703,1517
Selection Sort,38,779,76,741,1596
Selection Sort,39,819,78,780,1677
Selection Sort,40,860,80,820,1760
Selection Sort,41,902,82,861,1845
Selection Sort,42,945,84,903,1932
Selection Sort,43,989,86,946,2021
Selection Sort,44,1034,88,990,2112
Selection Sort,45,1080,90,1035,2205
Selection Sort,46,1127,92,1081,2300
Selection Sort,47,1175,94,1128,2397
Selection Sort,48,1224,96,1176,2496
Selection Sort,49,1274,98,1225,2597
Selection Sort,50,1325,100,1275,2700
Selection Sort,51,1377,102,1326,2805
Selection Sort,52,1430,104,1378,2912
Selection Sort,53,1484,106,1431,3021
Selection Sort,54,1539,108,1485,3132
Selection Sort,55,1595,110,1540,3245
Selection Sort,56,1652,112,1596,3360
Selection Sort,57,1710,114,1653,3477
Selection Sort,58,1769,116,1711,3596
Selection Sort,59,1829,118,1770,3717
Selection Sort,60,1890,120,1830,3840
Selection Sort,61,1952,122,1891,3965
Selection Sort,62,2015,124,1953,4092
Selection Sort,63,2079,126,2016,4221
Selection Sort,64,2144,128,2080,4352
Selection Sort,65,2210,130,2145,4485
Selection Sort,66,2277,132,2211,4620
Selection Sort,67,2345,134,2278,4757
Selection Sort,68,2414,136,2346,4896
Selection Sort,69,2484,138,2415,5037
Selection Sort,70,2555,140,2485,5180
Selection Sort,71,2627,142,2556,5325
Selection Sort,72,2700,144,2628,5472
Selection Sort,73,2774,146,2701,5621
Selection Sort,74,2849,148,2775,5772
Selection Sort,75,2925,150,2850,5925
Selection Sort,76,3002,152,2926,6080
Selection Sort,77,3080,154,3003,6237
Selection Sort,78,3159,156,3081,6396
Selection Sort,79,3239,158,3160,6557
Selection Sort,80,3320,160,3240,6720
Selection Sort,81,3402,162,3321,6885
Selection Sort,82,3485,164,3403,7052
Selection Sort,83,3569,166,3486,7221
Selection Sort,84,3654,168,3570,7392
Selection Sort,85,3740,170,3655,7565
Selection Sort,86,3827,172,3741,7740
Selection Sort,87,3915,174,3828,7917
Selection Sort,88,4004,176,3916,8096
Selection Sort,89,4094,178,4005,8277
Selection Sort,90,4185,180,4095,8460
Selection Sort,91,4277,182,4186,8645
Selection Sort,92,4370,184,4278,8832
Selection Sort,93,4464,186,4371,9021
Selection Sort,94,4559,188,4465,9212
Selection Sort,95,4655,190,4560,9405
Selection Sort,96,4752,192,4656,9600
Selection Sort,97,4850,194,4753,9797
Selection Sort,98,4949,196,4851,9996
Selection Sort,99,5049,198,4950,10197
Selection Sort,100,5150,200,5050,10400
Selection Sort,101,5252,202,5151,10605
Selection Sort,102,5355,204,5253,10812
Selection Sort,103,5459,206,5356,11021
Selection Sort,104,5564,208,5460,11232
Selection Sort,105,5670,210,5565,11445
Selection Sort,106,5777,212,5671,11660
Selection Sort,107,5885,214,5778,11877
Selection Sort,108,5994,216,5886,12096
Selection Sort,109,6104,218,5995,12317
Selection Sort,110,6215,220,6105,12540
Selection Sort,111,6327,222,6216,12765
Selection Sort,112,6440,224,6328,12992
Selection Sort,113,6554,226,6441,13221
Selection Sort,114,6669,228,6555,13452
Selection Sort,115,6785,230,6670,13685
Selection Sort,116,6902,232,6786,13920
Selection Sort,117,7020,234,6903,14157
Selection Sort,118,7139,236,7021,14396
Selection Sort,119,7259,238,7140,14637
Selection Sort,120,7380,240,7260,14880
Selection Sort,121,7502,242,7381,15125
Selection Sort,122,7625,244,7503,15372
Selection Sort,123,7749,246,7626,15621
Selection Sort,124,7874,248,7750,15872
Selection Sort,125,8000,250,7875,16125
Selection Sort,126,8127,252,8001,16380
Selection Sort,127,8255,254,8128,16637
Selection Sort,128,8384,256,8256,16896
Selection Sort,129,8514,258,8385,17157
Selection Sort,130,8645,260,8515,17420
Selection Sort,131,8777,262,8646,17685
Selection Sort,132,8910,264,8778,17952
Selection Sort,133,9044,266,8911,18221
Selection Sort,134,9179,268,9045,18492
Selection Sort,135,9315,270,9180,18765
Selection Sort,136,9452,272,9316,19040
Selection Sort,137,9590,274,9453,19317
Selection Sort,138,9729,276,9591,19596
Selection Sort,139,9869,278,9730,19877
Selection Sort,140,10010,280,9870,20160
Selection Sort,141,10152,282,10011,20445
Selection Sort,142,10295,284,10153,20732
Selection Sort,143,10439,286,10296,21021
Selection Sort,144,10584,288,10440,21312
Selection Sort,145,10730,290,10585,21605
Selection Sort,146,10877,292,10731,21900
Selection Sort,147,11025,294,10878,22197
Selection Sort,148,11174,296,11026,22496
Selection Sort,149,11324,298,11175,22797
Selection Sort,150,11475,300,11325,23100
Selection Sort,151,11627,302,11476,23405
Selection Sort,152,11780,304,11628,23712
Selection Sort,153,11934,306,11781,24021
Selection Sort,154,12089,308,11935,24332
Selection Sort,155,12245,310,12090,24645
Selection Sort,156,12402,312,12246,24960
Selection Sort,157,12560,314,12403,25277
Selection Sort,158,12719,316,12561,25596
Selection Sort,159,12879,318,12720,25917
Selection Sort,160,13040,320,12880,26240
Selection Sort,161,13202,322,13041,26565
Selection Sort,162,13365,324,13203,26892
Selection Sort,163,13529,326,13366,27221
Selection Sort,164,13694,328,13530,27552
Selection Sort,165,13860,330,13695,27885
Selection Sort,166,14027,332,13861,28220
Selection Sort,167,14195,334,14028,28557
Selection Sort,168,14364,336,14196,28896
Selection Sort,169,14534,338,14365,29237
Selection Sort,170,14705,340,14535,29580
Selection Sort,171,14877,342,14706,29925
Selection Sort,172,15050,344,14878,30272
Selection Sort,173,15224,346,15051,30621
Selection Sort,174,15399,348,15225,30972
Selection Sort,175,15575,350,15400,31325
Selection Sort,176,15752,352,15576,31680
Selection Sort,177,15930,354,15753,32037
Selection Sort,178,16109,356,15931,32396
Selection Sort,179,16289,358,16110,32757
Selection Sort,180,16470,360,16290,33120
Selection Sort,181,16652,362,16471,33485
Selection Sort,182,16835,364,16653,33852
Selection Sort,183,17019,366,16836,34221
Selection Sort,184,17204,368,17020,34592
Selection Sort,185,17390,370,17205,34965
Selection Sort,186,17577,372,17391,35340
Selection Sort,187,17765,374,17578,35717
Selection Sort,188,17954,376,17766,36096
Selection Sort,189,18144,378,17955,36477
Selection Sort,190,18335,380,18145,36860
Selection Sort,191,18527,382,18336,37245
Selection Sort,192,18720,384,18528,37632
Selection Sort,193,18914,386,18721,38021
Selection Sort,194,19109,388,18915,38412
Selection Sort,195,19305,390,19110,38805
Selection Sort,196,19502,392,19306,39200
Selection Sort,197,19700,394,19503,39597
Selection Sort,198,19899,396,19701,39996
Selection Sort,199,20099,398,19900,40397
Selection Sort,200,20300,400,20100,40800
Selection Sort,201,20502,402,20301,41205
Selection Sort,202,20705,404,20503,41612
Selection Sort,203,20909,406,20706,42021
Selection Sort,204,21114,408,20910,42432
Selection Sort,205,21320,410,21115,42845
Selection Sort,206,21527,412,21321,43260
Selection Sort,207,21735,414,21528,43677
Selection Sort,208,21944,416,21736,44096
Selection Sort,209,22154,418,21945,44517
Selection Sort,210,22365,420,22155,44940
Selection Sort,211,22577,422,22366,45365
Selection Sort,212,22790,424,22578,45792
Selection Sort,213,23004,426,22791,46221
Selection Sort,214,23219,428,23005,46652
Selection Sort,215,23435,430,23220,47085
Selection Sort,216,23652,432,23436,47520
Selection Sort,217,23870,434,23653,47957
Selection Sort,218,24089,436,23871,48396
Selection Sort,219,24309,438,24090,48837
Selection Sort,220,24530,440,24310,49280
Selection Sort,221,24752,442,24531,49725
Selection Sort,222,24975,444,24753,50172
Selection Sort,223,25199,446,24976,50621
Selection Sort,224,25424,448,25200,51072
Selection Sort,225,25650,450,25425,51525
Selection Sort,226,25877,452,25651,51980
Selection Sort,227,26105,454,25878,52437
Selection Sort,228,26334,456,26106,52896
Selection Sort,229,26564,458,26335,53357
Selection Sort,230,26795,460,26565,53820
Selection Sort,231,27027,462,26796,54285
Selection Sort,232,27260,464,27028,54752
Selection Sort,233,27494,466,27261,55221
Selection Sort,234,27729,468,27495,55692
Selection Sort,235,27965,470,27730,56165
Selection Sort,236,28202,472,27966,56640
Selection Sort,237,28440,474,28203,57117
Selection Sort,238,28679,476,28441,57596
Selection Sort,239,28919,478,28680,58077
Selection Sort,240,29160,480,28920,58560
Selection Sort,241,29402,482,29161,59045
Selection Sort,242,29645,484,29403,59532
Selection Sort,243,29889,486,29646,60021
Selection Sort,244,30134,488,29890,60512
Selection Sort,245,30380,490,30135,61005
Selection Sort,246,30627,492,30381,61500
Selection Sort,247,30875,494,30628,61997
Selection Sort,248,31124,496,30876,62496
Selection Sort,249,31374,498,31125,62997
Selection Sort,250,31625,500,31375,63500
Selection Sort,251,31877,502,31626,64005
Selection Sort,252,32130,504,31878,64512
Selection Sort,253,32384,506,32131,65021
Selection Sort,254,32639,508,32385,65532
Selection Sort,255,32895,510,32640,66045
Selection Sort,256,33152,512,32896,66560
Selection Sort,257,33410,514,33153,67077
Selection Sort,258,33669,516,33411,67596
Selection Sort,259,33929,518,33670,68117
Selection Sort,260,34190,520,33930,68640
Selection Sort,261,34452,522,34191,69165
Selection Sort,262,34715,524,34453,69692
Selection Sort,263,34979,526,34716,70221
Selection Sort,264,35244,528,34980,70752
Selection Sort,265,35510,530,35245,71285
Selection Sort,266,35777,532,35511,71820
Selection Sort,267,36045,534,35778,72357
Selection Sort,268,36314,536,36046,72896
Selection Sort,269,36584,538,36315,73437
Selection Sort,270,36855,540,36585,73980
Selection Sort,271,37127,542,36856,74525
Selection Sort,272,37400,544,37128,75072
Selection Sort,273,37674,546,37401,75621
Selection Sort,274,37949,548,37675,76172
Selection Sort,275,38225,550,37950,76725
Selection Sort,276,38502,552,38226,77280
Selection Sort,277,38780,554,38503,77837
Selection Sort,278,39059,556,38781,78396
Selection Sort,279,39339,558,39060,78957
Selection Sort,280,39620,560,39340,79520
Selection Sort,281,39902,562,39621,80085
Selection Sort,282,40185,564,39903,80652
Selection Sort,283,40469,566,40186,81221
Selection Sort,284,40754,568,40470,81792
Selection Sort,285,41040,570,40755,82365
Selection Sort,286,41327,572,41041,82940
Selection Sort,287,41615,574,41328,83517
Selection Sort,288,41904,576,41616,84096
Selection Sort,289,42194,578,41905,84677
Selection Sort,290,42485,580,42195,85260
Selection Sort,291,42777,582,42486,85845
Selection Sort,292,43070,584,42778,86432
Selection Sort,293,43364,586,43071,87021
Selection Sort,294,43659,588,43365,87612
Selection Sort,295,43955,590,43660,88205
Selection Sort,296,44252,592,43956,88800
Selection Sort,297,44550,594,44253,89397
Selection Sort,298,44849,596,44551,89996
Selection Sort,299,45149,598,44850,90597
Selection Sort,300,45450,600,45150,91200
Insertion Sort,2,2,0,2,4
Insertion Sort,3,6,2,6,14
Insertion Sort,4,11,6,10,27
Insertion Sort,5,14,6,14,34
Insertion Sort,6,19,8,20,47
Insertion Sort,7,23,8,26,57
Insertion Sort,8,36,12,46,94
Insertion Sort,9,37,10,48,95
Insertion Sort,10,51,16,68,135
Insertion Sort,11,61,16,86,163
Insertion Sort,12,61,12,88,161
Insertion Sort,13,72,18,102,192
Insertion Sort,14,88,20,130,238
Insertion Sort,15,96,20,144,260
Insertion Sort,16,97,24,140,261
Insertion Sort,17,106,28,152,286
Insertion Sort,18,128,28,194,350
Insertion Sort,19,108,30,150,288
Insertion Sort,20,130,32,190,352
Insertion Sort,21,150,38,222,410
Insertion Sort,22,163,38,246,447
Insertion Sort,23,188,38,294,520
Insertion Sort,24,192,42,296,530
Insertion Sort,25,226,46,358,630
Insertion Sort,26,192,44,290,526
Insertion Sort,27,241,46,384,671
Insertion Sort,28,262,48,422,732
Insertion Sort,29,331,54,552,937
Insertion Sort,30,346,54,580,980
Insertion Sort,31,307,52,502,861
Insertion Sort,32,297,50,482,829
Insertion Sort,33,339,54,560,953
Insertion Sort,34,329,62,530,921
Insertion Sort,35,481,64,830,1375
Insertion Sort,36,429,62,726,1217
Insertion Sort,37,496,70,850,1416
Insertion Sort,38,487,66,834,1387
Insertion Sort,39,435,72,722,1229
Insertion Sort,40,469,74,786,1329
Insertion Sort,41,511,74,868,1453
Insertion Sort,42,523,78,886,1487
Insertion Sort,43,515,72,874,1461
Insertion Sort,44,579,80,992,1651
Insertion Sort,45,543,82,916,1541
Insertion Sort,46,665,84,1156,1905
Insertion Sort,47,604,82,1034,1720
Insertion Sort,48,749,86,1318,2153
Insertion Sort,49,731,90,1276,2097
Insertion Sort,50,678,90,1168,1936
Insertion Sort,51,717,92,1242,2051
Insertion Sort,52,864,96,1530,2490
Insertion Sort,53,881,92,1566,2539
Insertion Sort,54,831,98,1458,2387
Insertion Sort,55,890,102,1570,2562
Insertion Sort,56,892,104,1570,2566
Insertion Sort,57,971,102,1728,2801
Insertion Sort,58,926,106,1632,2664
Insertion Sort,59,1011,110,1796,2917
Insertion Sort,60,1005,112,1780,2897
Insertion Sort,61,1080,114,1926,3120
Insertion Sort,62,1168,114,2100,3382
Insertion Sort,63,985,116,1730,2831
Insertion Sort,64,1287,122,2326,3735
Insertion Sort,65,1209,124,2166,3499
Insertion Sort,66,1290,124,2326,3740
Insertion Sort,67,1267,120,2282,3669
Insertion Sort,68,1290,122,2324,3736
Insertion Sort,69,1419,136,2566,4121
Insertion Sort,70,1260,130,2252,3642
Insertion Sort,71,1225,134,2176,3535
Insertion Sort,72,1493,132,2712,4337
Insertion Sort,73,1383,140,2482,4005
Insertion Sort,74,1680,138,3076,4894
Insertion Sort,75,1579,142,2868,4589
Insertion Sort,76,1714,142,3136,4992
Insertion Sort,77,1853,150,3404,5407
Insertion Sort,78,1513,142,2730,4385
Insertion Sort,79,1747,140,3198,5085
Insertion Sort,80,1847,148,3388,5383
Insertion Sort,81,1975,150,3640,5765
Insertion Sort,82,1951,160,3580,5691
Insertion Sort,83,2065,156,3810,6031
Insertion Sort,84,2149,154,3978,6281
Insertion Sort,85,2162,164,3992,6318
Insertion Sort,86,1981,164,3628,5773
Insertion Sort,87,2168,164,4000,6332
Insertion Sort,88,2270,168,4198,6636
Insertion Sort,89,2027,172,3706,5905
Insertion Sort,90,2107,162,3874,6143
Insertion Sort,91,2418,170,4486,7074
Insertion Sort,92,2266,168,4182,6616
Insertion Sort,93,2405,174,4452,7031
Insertion Sort,94,2615,180,4864,7659
Insertion Sort,95,2569,180,4770,7519
Insertion Sort,96,2692,184,5010,7886
Insertion Sort,97,2673,186,4968,7827
Insertion Sort,98,2438,184,4498,7120
Insertion Sort,99,2888,186,5394,8468
Insertion Sort,100,2479,184,4576,7239
Insertion Sort,101,2854,192,5316,8362
Insertion Sort,102,2879,186,5370,8435
Insertion Sort,103,3289,198,6176,9663
Insertion Sort,104,2873,198,5342,8413
Insertion Sort,105,2802,198,5198,8198
Insertion Sort,106,3015,202,5618,8835
Insertion Sort,107,3363,194,6320,9877
Insertion Sort,108,3544,204,6670,10418
Insertion Sort,109,3361,208,6298,9867
Insertion Sort,110,3363,208,6300,9871
Insertion Sort,111,3499,216,6562,10277
Insertion Sort,112,3361,202,6298,9861
Insertion Sort,113,3532,216,6624,10372
Insertion Sort,114,3347,222,6246,9815
Insertion Sort,115,3551,222,6652,10425
Insertion Sort,116,3560,222,6668,10450
Insertion Sort,117,3809,224,7162,11195
Insertion Sort,118,3742,234,7016,10992
Insertion Sort,119,4012,222,7566,11800
Insertion Sort,120,4026,232,7582,11840
Insertion Sort,121,4017,228,7566,11811
Insertion Sort,122,4263,234,8050,12547
Insertion Sort,123,4223,234,7968,12425
Insertion Sort,124,4047,240,7608,11895
Insertion Sort,125,4687,234,8892,13813
Insertion Sort,126,3968,246,7440,11654
Insertion Sort,127,4150,246,7802,12198
Insertion Sort,128,4145,248,7788,12181
Insertion Sort,129,4766,252,9024,14042
Insertion Sort,130,4625,250,8742,13617
Insertion Sort,131,4445,258,8372,13075
Insertion Sort,132,4386,256,8254,12896
Insertion Sort,133,4994,262,9462,14718
Insertion Sort,134,4631,250,8746,13627
Insertion Sort,135,4711,262,8892,13865
Insertion Sort,136,5242,260,9954,15456
Insertion Sort,137,4950,260,9368,14578
Insertion Sort,138,5044,250,9564,14858
Insertion Sort,139,5631,266,10720,16617
Insertion Sort,140,5032,272,9514,14818
Insertion Sort,141,5347,272,10142,15761
Insertion Sort,142,5216,276,9874,15366
Insertion Sort,143,4650,280,8736,13666
Insertion Sort,144,5126,278,9688,15092
Insertion Sort,145,5578,282,10586,16446
Insertion Sort,146,5795,278,11022,17095
Insertion Sort,147,6861,290,13140,20291
Insertion Sort,148,5809,290,11034,17133
Insertion Sort,149,5917,276,11262,17455
Insertion Sort,150,5796,276,11018,17090
Insertion Sort,151,5820,298,11042,17160
Insertion Sort,152,6261,282,11938,18481
Insertion Sort,153,6045,296,11490,17831
Insertion Sort,154,6333,298,12062,18693
Insertion Sort,155,6959,298,13312,20569
Insertion Sort,156,6062,298,11516,17876
Insertion Sort,157,6494,302,12374,19170
Insertion Sort,158,6759,302,12902,19963
Insertion Sort,159,6696,310,12766,19772
Insertion Sort,160,6796,312,12962,20070
Insertion Sort,161,6768,304,12912,19984
Insertion Sort,162,6528,312,12422,19262
Insertion Sort,163,7232,316,13824,21372
Insertion Sort,164,6598,320,12550,19468
Insertion Sort,165,7046,320,13444,20810
Insertion Sort,166,7729,314,14814,22857
Insertion Sort,167,7385,322,14116,21823
Insertion Sort,168,7919,326,15178,23423
Insertion Sort,169,7516,332,14364,22212
Insertion Sort,170,7913,330,15158,23401
Insertion Sort,171,7896,332,15120,23348
Insertion Sort,172,7384,322,14104,21810
Insertion Sort,173,8397,336,16114,24847
Insertion Sort,174,8078,336,15474,23888
Insertion Sort,175,8203,338,15720,24261
Insertion Sort,176,8546,340,16402,25288
Insertion Sort,177,7926,344,15156,23426
Insertion Sort,178,7934,342,15172,23448
Insertion Sort,179,8823,350,16940,26113
Insertion Sort,180,8563,352,16416,25331
Insertion Sort,181,8846,350,16982,26178
Insertion Sort,182,9430,350,18148,27928
Insertion Sort,183,8807,354,16896,26057
Insertion Sort,184,8991,356,17260,26607
Insertion Sort,185,8906,360,17084,26350
Insertion Sort,186,9036,348,17354,26738
Insertion Sort,187,9184,358,17638,27180
Insertion Sort,188,8997,364,17256,26617
Insertion Sort,189,8912,366,17082,26360
Insertion Sort,190,10001,366,19258,29625
Insertion Sort,191,9263,368,17778,27409
Insertion Sort,192,10507,374,20258,31139
Insertion Sort,193,10056,378,19350,29784
Insertion Sort,194,9760,378,18756,28894
Insertion Sort,195,10095,382,19420,29897
Insertion Sort,196,9968,384,19162,29514
Insertion Sort,197,10082,382,19390,29854
Insertion Sort,198,10013,386,19246,29645
Insertion Sort,199,11178,386,21574,33138
Insertion Sort,200,10688,384,20594,31666
Insertion Sort,201,10731,392,20670,31793
Insertion Sort,202,10875,388,20960,32223
Insertion Sort,203,11076,392,21356,32824
Insertion Sort,204,10600,396,20398,31394
Insertion Sort,205,11185,404,21558,33147
Insertion Sort,206,11106,398,21404,32908
Insertion Sort,207,11729,406,22640,34775
Insertion Sort,208,12075,406,23330,35811
Insertion Sort,209,12094,404,23368,35866
Insertion Sort,210,11542,410,22256,34208
Insertion Sort,211,11446,408,22064,33918
Insertion Sort,212,12975,410,25118,38503
Insertion Sort,213,11277,410,21720,33407
Insertion Sort,214,12824,418,24804,38046
Insertion Sort,215,12471,410,24104,36985
Insertion Sort,216,11605,410,22370,34385
Insertion Sort,217,13014,428,25168,38610
Insertion Sort,218,12108,426,23356,35890
Insertion Sort,219,12266,426,23670,36362
Insertion Sort,220,12163,426,23462,36051
Insertion Sort,221,11529,420,22198,34147
Insertion Sort,222,12006,438,23132,35576
Insertion Sort,223,12660,432,24444,37536
Insertion Sort,224,13624,438,26364,40426
Insertion Sort,225,12584,442,24278,37304
Insertion Sort,226,13608,442,26324,40374
Insertion Sort,227,13468,446,26038,39952
Insertion Sort,228,14081,440,27268,41789
Insertion Sort,229,13773,442,26648,40863
Insertion Sort,230,13063,450,25218,38731
Insertion Sort,231,12894,448,24880,38222
Insertion Sort,232,13914,456,26910,41280
Insertion Sort,233,14146,452,27376,41974
Insertion Sort,234,14660,460,28394,43514
Insertion Sort,235,15342,462,29754,45558
Insertion Sort,236,14163,460,27396,42019
Insertion Sort,237,14877,456,28826,44159
Insertion Sort,238,14318,456,27706,42480
Insertion Sort,239,15409,460,29882,45751
Insertion Sort,240,15041,468,29136,44645
Insertion Sort,241,14601,468,28254,43323
Insertion Sort,242,14562,464,28178,43204
Insertion Sort,243,15525,476,30090,46091
Insertion Sort,244,15699,478,30434,46611
Insertion Sort,245,14397,470,27836,42703
Insertion Sort,246,16306,480,31642,48428
Insertion Sort,247,15492,484,30008,45984
Insertion Sort,248,16359,480,31744,48583
Insertion Sort,249,17919,482,34860,53261
Insertion Sort,250,15595,490,30202,46287
Insertion Sort,251,15604,494,30214,46312
Insertion Sort,252,17590,494,34184,52268
Insertion Sort,253,15422,494,29846,45762
Insertion Sort,254,16221,500,31436,48157
Insertion Sort,255,17997,496,34990,53483
Insertion Sort,256,16577,496,32148,49221
Insertion Sort,257,17895,502,34776,53173
Insertion Sort,258,16676,500,32338,49514
Insertion Sort,259,18551,508,36078,55137
Insertion Sort,260,16766,518,32496,49780
Insertion Sort,261,16755,514,32476,49745
Insertion Sort,262,17434,516,33830,51780
Insertion Sort,263,18653,516,36266,55435
Insertion Sort,264,17843,518,34642,53003
Insertion Sort,265,18178,516,35312,54006
Insertion Sort,266,19053,522,37054,56629
Insertion Sort,267,18953,518,36856,56327
Insertion Sort,268,18438,530,35812,54780
Insertion Sort,269,19658,530,38250,58438
Insertion Sort,270,18087,526,35110,53723
Insertion Sort,271,19105,520,37150,56775
Insertion Sort,272,19976,534,38876,59386
Insertion Sort,273,19612,528,38152,58292
Insertion Sort,274,18750,538,36416,55704
Insertion Sort,275,19890,540,38692,59122
Insertion Sort,276,18758,536,36430,55724
Insertion Sort,277,20244,538,39398,60180
Insertion Sort,278,21575,546,42050,64171
Insertion Sort,279,18899,542,36700,56141
Insertion Sort,280,21755,548,42404,64707
Insertion Sort,281,20086,554,39058,59698
Insertion Sort,282,19574,556,38030,58160
Insertion Sort,283,21568,548,42024,64140
Insertion Sort,284,21522,560,41918,64000
Insertion Sort,285,20834,556,40544,61934
Insertion Sort,286,20659,554,40194,61407
Insertion Sort,287,20718,564,40300,61582
Insertion Sort,288,21846,562,42556,64964
Insertion Sort,289,22132,566,43122,65820
Insertion Sort,290,21881,566,42618,65065
Insertion Sort,291,20462,570,39774,60806
Insertion Sort,292,22174,580,43186,65940
Insertion Sort,293,23344,576,45528,69448
Insertion Sort,294,21914,574,42668,65156
Insertion Sort,295,20813,574,40464,61851
Insertion Sort,296,23195,582,45218,68995
Insertion Sort,297,21250,582,41326,63158
Insertion Sort,298,23368,578,45564,69510
Insertion Sort,299,24249,584,47318,72151
Insertion Sort,300,22970,592,44750,68312
Merge Sort,2,2,2,2,6
Merge Sort,3,6,6,9,21
Merge Sort,4,11,7,14,32
Merge Sort,5,17,11,23,51
Merge Sort,6,24,14,34,72
Merge Sort,7,30,16,39,85
Merge Sort,8,37,17,46,100
Merge Sort,9,45,21,57,123
Merge Sort,10,53,25,68,146
Merge Sort,11,63,27,83,173
Merge Sort,12,70,32,92,194
Merge Sort,13,79,33,101,213
Merge Sort,14,88,34,110,232
Merge Sort,15,94,38,113,245
Merge Sort,16,103,39,122,264
Merge Sort,17,112,44,133,289
Merge Sort,18,121,49,144,314
Merge Sort,19,135,49,165,349
Merge Sort,20,142,56,172,370
Merge Sort,21,155,57,191,403
Merge Sort,22,167,59,208,434
Merge Sort,23,177,63,221,461
Merge Sort,24,186,68,232,486
Merge Sort,25,200,66,249,515
Merge Sort,26,209,69,256,534
Merge Sort,27,220,70,267,557
Merge Sort,28,227,75,270,572
Merge Sort,29,240,74,285,599
Merge Sort,30,244,82,282,608
Merge Sort,31,256,82,295,633
Merge Sort,32,265,85,302,652
Merge Sort,33,278,88,319,685
Merge Sort,34,293,89,340,722
Merge Sort,35,307,91,359,757
Merge Sort,36,314,100,364,778
Merge Sort,37,335,95,397,827
Merge Sort,38,337,109,392,838
Merge Sort,39,353,109,415,877
Merge Sort,40,370,108,440,918
Merge Sort,41,379,115,449,943
Merge Sort,42,393,117,468,978
Merge Sort,43,410,116,493,1019
Merge Sort,44,414,128,492,1034
Merge Sort,45,432,126,519,1077
Merge Sort,46,443,131,532,1106
Merge Sort,47,458,132,553,1143
Merge Sort,48,468,138,564,1170
Merge Sort,49,481,139,577,1197
Merge Sort,50,494,140,590,1224
Merge Sort,51,500,148,589,1237
Merge Sort,52,521,141,618,1280
Merge Sort,53,518,158,599,1275
Merge Sort,54,530,160,610,1300
Merge Sort,55,548,156,633,1337
Merge Sort,56,562,156,648,1366
Merge Sort,57,572,160,655,1387
Merge Sort,58,587,159,672,1418
Merge Sort,59,600,160,685,1445
Merge Sort,60,607,167,686,1460
Merge Sort,61,619,169,697,1485
Merge Sort,62,627,175,700,1502
Merge Sort,63,644,172,721,1537
Merge Sort,64,659,171,738,1568
Merge Sort,65,676,172,761,1609
Merge Sort,66,686,180,770,1636
Merge Sort,67,697,187,781,1665
Merge Sort,68,713,189,802,1704
Merge Sort,69,725,195,815,1735
Merge Sort,70,741,197,836,1774
Merge Sort,71,764,192,871,1827
Merge Sort,72,777,197,886,1860
Merge Sort,73,793,199,907,1899
Merge Sort,74,803,207,916,1926
Merge Sort,75,810,218,919,1947
Merge Sort,76,835,211,958,2004
Merge Sort,77,844,220,965,2029
Merge Sort,78,855,227,976,2058
Merge Sort,79,869,231,993,2093
Merge Sort,80,882,236,1008,2126
Merge Sort,81,904,232,1041,2177
Merge Sort,82,917,237,1056,2210
Merge Sort,83,935,237,1081,2253
Merge Sort,84,941,249,1082,2272
Merge Sort,85,969,239,1127,2335
Merge Sort,86,988,238,1154,2380
Merge Sort,87,993,251,1153,2397
Merge Sort,88,1001,261,1158,2420
Merge Sort,89,1019,261,1183,2463
Merge Sort,90,1037,261,1208,2506
Merge Sort,91,1046,270,1215,2531
Merge Sort,92,1062,272,1236,2570
Merge Sort,93,1087,265,1275,2627
Merge Sort,94,1101,269,1292,2662
Merge Sort,95,1113,275,1305,2693
Merge Sort,96,1126,280,1320,2726
Merge Sort,97,1137,285,1327,2749
Merge Sort,98,1135,303,1308,2746
Merge Sort,99,1152,302,1327,2781
Merge Sort,100,1173,297,1354,2824
Merge Sort,101,1203,283,1399,2885
Merge Sort,102,1219,283,1416,2918
Merge Sort,103,1223,295,1409,2927
Merge Sort,104,1226,308,1400,2934
Merge Sort,105,1245,305,1423,2973
Merge Sort,106,1254,312,1426,2992
Merge Sort,107,1268,314,1439,3021
Merge Sort,108,1292,306,1472,3070
Merge Sort,109,1308,306,1489,3103
Merge Sort,110,1310,320,1478,3108
Merge Sort,111,1324,322,1491,3137
Merge Sort,112,1334,328,1496,3158
Merge Sort,113,1351,327,1515,3193
Merge Sort,114,1373,321,1544,3238
Merge Sort,115,1388,322,1559,3269
Merge Sort,116,1406,320,1580,3306
Merge Sort,117,1412,330,1577,3319
Merge Sort,118,1429,329,1596,3354
Merge Sort,119,1450,324,1623,3397
Merge Sort,120,1462,328,1632,3422
Merge Sort,121,1468,338,1629,3435
Merge Sort,122,1491,331,1660,3482
Merge Sort,123,1499,339,1661,3499
Merge Sort,124,1513,341,1674,3528
Merge Sort,125,1522,348,1677,3547
Merge Sort,126,1541,345,1700,3586
Merge Sort,127,1562,340,1727,3629
Merge Sort,128,1574,344,1736,3654
Merge Sort,129,1587,351,1749,3687
Merge Sort,130,1601,357,1764,3722
Merge Sort,131,1625,353,1799,3777
Merge Sort,132,1644,354,1824,3822
Merge Sort,133,1656,362,1835,3853
Merge Sort,134,1664,374,1838,3876
Merge Sort,135,1687,371,1871,3929
Merge Sort,136,1688,390,1860,3938
Merge Sort,137,1719,379,1909,4007
Merge Sort,138,1731,387,1920,4038
Merge Sort,139,1760,378,1965,4103
Merge Sort,140,1768,390,1968,4126
Merge Sort,141,1782,396,1983,4161
Merge Sort,142,1801,397,2008,4206
Merge Sort,143,1800,418,1993,4211
Merge Sort,144,1828,410,2036,4274
Merge Sort,145,1838,420,2043,4301
Merge Sort,146,1859,419,2072,4350
Merge Sort,147,1871,427,2083,4381
Merge Sort,148,1902,416,2132,4450
Merge Sort,149,1902,436,2119,4457
Merge Sort,150,1924,434,2150,4508
Merge Sort,151,1948,430,2185,4563
Merge Sort,152,1964,434,2204,4602
Merge Sort,153,1981,437,2225,4643
Merge Sort,154,2002,436,2254,4692
Merge Sort,155,2016,442,2269,4727
Merge Sort,156,2043,435,2310,4788
Merge Sort,157,2040,458,2291,4789
Merge Sort,158,2067,451,2332,4850
Merge Sort,159,2083,455,2351,4889
Merge Sort,160,2082,476,2336,4894
Merge Sort,161,2118,460,2395,4973
Merge Sort,162,2131,467,2408,5006
Merge Sort,163,2152,466,2437,5055
Merge Sort,164,2171,467,2462,5100
Merge Sort,165,2160,498,2427,5085
Merge Sort,166,2195,483,2484,5162
Merge Sort,167,2224,474,2529,5227
Merge Sort,168,2224,494,2516,5234
Merge Sort,169,2237,501,2529,5267
Merge Sort,170,2252,506,2546,5304
Merge Sort,171,2276,502,2581,5359
Merge Sort,172,2294,504,2604,5402
Merge Sort,173,2316,502,2635,5453
Merge Sort,174,2322,516,2634,5472
Merge Sort,175,2348,510,2673,5531
Merge Sort,176,2357,521,2678,5556
Merge Sort,177,2373,525,2697,5595
Merge Sort,178,2398,520,2734,5652
Merge Sort,179,2414,524,2753,5691
Merge Sort,180,2430,528,2772,5730
Merge Sort,181,2433,545,2765,5743
Merge Sort,182,2455,543,2796,5794
Merge Sort,183,2468,550,2809,5827
Merge Sort,184,2488,550,2836,5874
Merge Sort,185,2505,553,2857,5915
Merge Sort,186,2529,549,2892,5970
Merge Sort,187,2533,565,2887,5985
Merge Sort,188,2567,551,2942,6060
Merge Sort,189,2555,583,2905,6043
Merge Sort,190,2603,555,2988,6146
Merge Sort,191,2620,558,3009,6187
Merge Sort,192,2624,574,3004,6202
Merge Sort,193,2637,579,3013,6229
Merge Sort,194,2655,579,3032,6266
Merge Sort,195,2685,567,3075,6327
Merge Sort,196,2702,568,3092,6362
Merge Sort,197,2700,588,3071,6359
Merge Sort,198,2724,582,3102,6408
Merge Sort,199,2734,590,3105,6429
Merge Sort,200,2755,587,3130,6472
Merge Sort,201,2760,600,3123,6483
Merge Sort,202,2778,600,3142,6520
Merge Sort,203,2790,606,3149,6545
Merge Sort,204,2829,585,3210,6624
Merge Sort,205,2832,600,3199,6631
Merge Sort,206,2851,599,3220,6670
Merge Sort,207,2872,596,3245,6713
Merge Sort,208,2891,595,3266,6752
Merge Sort,209,2890,614,3247,6751
Merge Sort,210,2908,614,3266,6788
Merge Sort,211,2933,607,3299,6839
Merge Sort,212,2941,617,3298,6856
Merge Sort,213,2979,597,3357,6933
Merge Sort,214,2993,601,3368,6962
Merge Sort,215,2989,623,3343,6955
Merge Sort,216,3019,611,3386,7016
Merge Sort,217,3023,625,3377,7025
Merge Sort,218,3043,623,3400,7066
Merge Sort,219,3049,635,3395,7079
Merge Sort,220,3078,624,3436,7138
Merge Sort,221,3091,629,3445,7165
Merge Sort,222,3106,632,3458,7196
Merge Sort,223,3114,642,3457,7213
Merge Sort,224,3139,635,3490,7264
Merge Sort,225,3143,649,3481,7273
Merge Sort,226,3170,640,3518,7328
Merge Sort,227,3189,639,3539,7367
Merge Sort,228,3204,642,3552,7398
Merge Sort,229,3205,659,3537,7401
Merge Sort,230,3223,659,3556,7438
Merge Sort,231,3245,655,3583,7483
Merge Sort,232,3270,648,3616,7534
Merge Sort,233,3270,666,3599,7535
Merge Sort,234,3302,652,3646,7600
Merge Sort,235,3314,658,3653,7625
Merge Sort,236,3320,670,3648,7638
Merge Sort,237,3332,676,3655,7663
Merge Sort,238,3356,670,3686,7712
Merge Sort,239,3370,674,3697,7741
Merge Sort,240,3395,667,3730,7792
Merge Sort,241,3409,671,3741,7821
Merge Sort,242,3418,680,3742,7840
Merge Sort,243,3436,680,3761,7877
Merge Sort,244,3454,680,3780,7914
Merge Sort,245,3478,674,3811,7963
Merge Sort,246,3486,684,3810,7980
Merge Sort,247,3498,690,3817,8005
Merge Sort,248,3523,683,3850,8056
Merge Sort,249,3535,689,3857,8081
Merge Sort,250,3543,699,3856,8098
Merge Sort,251,3576,684,3905,8165
Merge Sort,252,3574,704,3884,8162
Merge Sort,253,3607,689,3933,8229
Merge Sort,254,3613,701,3928,8242
Merge Sort,255,3629,703,3943,8275
Merge Sort,256,3651,699,3970,8320
Merge Sort,257,3672,700,3997,8369
Merge Sort,258,3688,706,4014,8408
Merge Sort,259,3706,710,4035,8451
Merge Sort,260,3719,719,4046,8484
Merge Sort,261,3736,724,4065,8525
Merge Sort,262,3745,737,4068,8550
Merge Sort,263,3763,741,4089,8593
Merge Sort,264,3789,737,4126,8652
Merge Sort,265,3802,746,4137,8685
Merge Sort,266,3833,737,4184,8754
Merge Sort,267,3842,750,4187,8779
Merge Sort,268,3872,742,4232,8846
Merge Sort,269,3891,745,4255,8891
Merge Sort,270,3917,741,4292,8950
Merge Sort,271,3914,766,4271,8951
Merge Sort,272,3929,773,4286,8988
Merge Sort,273,3970,754,4353,9077
Merge Sort,274,3976,770,4350,9096
Merge Sort,275,4003,765,4389,9157
Merge Sort,276,4017,773,4402,9192
Merge Sort,277,4022,790,4397,9209
Merge Sort,278,4052,782,4442,9276
Merge Sort,279,4072,784,4467,9323
Merge Sort,280,4082,796,4472,9350
Merge Sort,281,4089,811,4471,9371
Merge Sort,282,4132,790,4542,9464
Merge Sort,283,4136,808,4535,9479
Merge Sort,284,4160,806,4568,9534
Merge Sort,285,4179,809,4591,9579
Merge Sort,286,4204,806,4626,9636
Merge Sort,287,4210,822,4623,9655
Merge Sort,288,4236,818,4660,9714
Merge Sort,289,4251,825,4675,9751
Merge Sort,290,4282,816,4722,9820
Merge Sort,291,4276,844,4695,9815
Merge Sort,292,4296,846,4720,9862
Merge Sort,293,4320,844,4753,9917
Merge Sort,294,4351,835,4800,9986
Merge Sort,295,4369,839,4821,10029
Merge Sort,296,4375,855,4818,10048
Merge Sort,297,4404,848,4861,10113
Merge Sort,298,4426,848,4890,10164
Merge Sort,299,4428,868,4879,10175
Merge Sort,300,4466,852,4940,10258
Quick Sort,2,2,2,1,5
Quick Sort,3,6,8,13,27
Quick Sort,4,9,14,28,51
Quick Sort,5,17,26,46,89
Quick Sort,6,15,22,34,71
Quick Sort,7,21,32,52,105
Quick Sort,8,22,34,55,111
Quick Sort,9,26,42,67,135
Quick Sort,10,32,50,79,161
Quick Sort,11,45,76,124,245
Quick Sort,12,43,70,112,225
Quick Sort,13,47,78,136,261
Quick Sort,14,51,84,136,271
Quick Sort,15,51,84,130,265
Quick Sort,16,61,102,166,329
Quick Sort,17,74,126,211,411
Quick Sort,18,67,112,178,357
Quick Sort,19,82,140,235,457
Quick Sort,20,94,160,247,501
Quick Sort,21,93,160,268,521
Quick Sort,22,98,170,283,551
Quick Sort,23,111,190,310,611
Quick Sort,24,119,206,334,659
Quick Sort,25,129,224,358,711
Quick Sort,26,129,226,358,713
Quick Sort,27,157,282,448,887
Quick Sort,28,165,292,454,911
Quick Sort,29,179,324,520,1023
Quick Sort,30,168,296,481,945
Quick Sort,31,150,260,421,831
Quick Sort,32,186,328,541,1055
Quick Sort,33,165,286,460,911
Quick Sort,34,171,296,460,927
Quick Sort,35,232,416,655,1303
Quick Sort,36,209,366,592,1167
Quick Sort,37,231,412,670,1313
Quick Sort,38,195,340,544,1079
Quick Sort,39,244,436,691,1371
Quick Sort,40,251,452,712,1415
Quick Sort,41,236,420,667,1323
Quick Sort,42,257,464,748,1469
Quick Sort,43,248,436,697,1381
Quick Sort,44,245,434,700,1379
Quick Sort,45,241,424,670,1335
Quick Sort,46,267,470,748,1485
Quick Sort,47,280,498,805,1583
Quick Sort,48,252,444,703,1399
Quick Sort,49,323,584,922,1829
Quick Sort,50,302,538,877,1717
Quick Sort,51,304,538,859,1701
Quick Sort,52,302,536,871,1709
Quick Sort,53,370,674,1075,2119
Quick Sort,54,309,548,874,1731
Quick Sort,55,373,676,1066,2115
Quick Sort,56,364,664,1045,2073
Quick Sort,57,358,638,1003,1999
Quick Sort,58,361,640,1006,2007
Quick Sort,59,366,650,1039,2055
Quick Sort,60,370,666,1069,2105
Quick Sort,61,412,740,1171,2323
Quick Sort,62,426,770,1213,2409
Quick Sort,63,487,888,1379,2754
Quick Sort,64,393,704,1120,2217
Quick Sort,65,432,778,1231,2441
Quick Sort,66,430,768,1225,2423
Quick Sort,67,474,856,1351,2681
Quick Sort,68,430,772,1219,2421
Quick Sort,69,497,902,1420,2819
Quick Sort,70,502,908,1435,2845
Quick Sort,71,477,862,1366,2705
Quick Sort,72,514,934,1471,2919
Quick Sort,73,560,1018,1609,3187
Quick Sort,74,509,928,1462,2899
Quick Sort,75,512,926,1459,2897
Quick Sort,76,499,892,1420,2811
Quick Sort,77,629,1152,1822,3603
Quick Sort,78,493,884,1384,2761
Quick Sort,79,508,908,1435,2851
Quick Sort,80,506,908,1453,2867
Quick Sort,81,563,1018,1606,3187
Quick Sort,82,688,1268,1981,3937
Quick Sort,83,595,1078,1720,3393
Quick Sort,84,607,1102,1738,3447
Quick Sort,85,641,1168,1834,3643
Quick Sort,86,560,1002,1573,3135
Quick Sort,87,677,1232,1930,3839
Quick Sort,88,634,1154,1802,3590
Quick Sort,89,605,1094,1738,3437
Quick Sort,90,652,1180,1855,3687
Quick Sort,91,684,1242,1945,3871
Quick Sort,92,653,1182,1852,3687
Quick Sort,93,656,1180,1849,3685
Quick Sort,94,680,1234,1945,3859
Quick Sort,95,707,1292,2038,4037
Quick Sort,96,733,1332,2086,4151
Quick Sort,97,672,1214,1903,3789
Quick Sort,98,883,1632,2554,5069
Quick Sort,99,829,1530,2410,4769
Quick Sort,100,715,1302,2062,4079
Quick Sort,101,765,1388,2182,4335
Quick Sort,102,788,1438,2269,4495
Quick Sort,103,826,1508,2377,4711
Quick Sort,104,774,1414,2227,4415
Quick Sort,105,714,1290,2023,4027
Quick Sort,106,780,1420,2221,4421
Quick Sort,107,903,1668,2626,5197
Quick Sort,108,732,1326,2077,4135
Quick Sort,109,853,1564,2440,4857
Quick Sort,110,827,1500,2344,4671
Quick Sort,111,876,1604,2497,4977
Quick Sort,112,981,1816,2842,5639
Quick Sort,113,839,1520,2375,4734
Quick Sort,114,1108,2058,3205,6371
Quick Sort,115,886,1614,2551,5051
Quick Sort,116,899,1642,2579,5120
Quick Sort,117,844,1540,2407,4791
Quick Sort,118,998,1836,2887,5721
Quick Sort,119,1065,1974,3088,6127
Quick Sort,120,1084,2004,3103,6191
Quick Sort,121,925,1682,2662,5269
Quick Sort,122,947,1730,2716,5393
Quick Sort,123,972,1778,2755,5505
Quick Sort,124,1045,1918,3017,5980
Quick Sort,125,1234,2300,3577,7111
Quick Sort,126,966,1762,2761,5489
Quick Sort,127,1058,1960,3061,6079
Quick Sort,128,1079,1984,3100,6163
Quick Sort,129,1349,2532,3917,7798
Quick Sort,130,971,1764,2776,5511
Quick Sort,131,1078,1986,3109,6173
Quick Sort,132,983,1790,2801,5574
Quick Sort,133,1191,2206,3442,6839
Quick Sort,134,998,1820,2852,5670
Quick Sort,135,1146,2108,3313,6567
Quick Sort,136,1095,2008,3154,6257
Quick Sort,137,1107,2036,3184,6327
Quick Sort,138,1158,2140,3331,6629
Quick Sort,139,1181,2166,3388,6735
Quick Sort,140,1100,2014,3151,6265
Quick Sort,141,1134,2082,3253,6469
Quick Sort,142,1268,2344,3661,7273
Quick Sort,143,1299,2412,3766,7477
Quick Sort,144,1484,2780,4303,8567
Quick Sort,145,1363,2526,3928,7817
Quick Sort,146,1210,2230,3499,6939
Quick Sort,147,1236,2272,3578,7086
Quick Sort,148,1299,2408,3766,7473
Quick Sort,149,1286,2372,3691,7349
Quick Sort,150,1134,2072,3265,6471
Quick Sort,151,1237,2276,3556,7069
Quick Sort,152,1285,2366,3707,7358
Quick Sort,153,1198,2194,3457,6849
Quick Sort,154,1178,2148,3355,6681
Quick Sort,155,1276,2344,3691,7311
Quick Sort,156,1293,2388,3748,7429
Quick Sort,157,1172,2138,3361,6671
Quick Sort,158,1378,2550,3985,7913
Quick Sort,159,1328,2446,3829,7603
Quick Sort,160,1359,2508,3886,7753
Quick Sort,161,1584,2946,4610,9140
Quick Sort,162,1255,2292,3574,7121
Quick Sort,163,1566,2902,4519,8987
Quick Sort,164,1615,3008,4702,9325
Quick Sort,165,1404,2580,4057,8041
Quick Sort,166,1439,2660,4157,8256
Quick Sort,167,1354,2486,3889,7729
Quick Sort,168,1486,2752,4285,8523
Quick Sort,169,1383,2548,4012,7943
Quick Sort,170,1740,3258,5095,10093
Quick Sort,171,1306,2378,3745,7429
Quick Sort,172,1503,2778,4330,8611
Quick Sort,173,1463,2698,4210,8371
Quick Sort,174,1476,2744,4321,8541
Quick Sort,175,1535,2836,4402,8773
Quick Sort,176,1586,2932,4555,9073
Quick Sort,177,1460,2690,4201,8351
Quick Sort,178,1507,2786,4354,8647
Quick Sort,179,1577,2926,4553,9056
Quick Sort,180,1568,2896,4501,8965
Quick Sort,181,1603,2972,4654,9229
Quick Sort,182,1503,2758,4318,8579
Quick Sort,183,1464,2684,4201,8349
Quick Sort,184,1384,2528,3979,7891
Quick Sort,185,1572,2894,4513,8979
Quick Sort,186,1712,3170,4975,9857
Quick Sort,187,1446,2650,4147,8243
Quick Sort,188,1794,3332,5161,10287
Quick Sort,189,1562,2868,4477,8907
Quick Sort,190,1785,3320,5140,10245
Quick Sort,191,1680,3110,4879,9669
Quick Sort,192,1678,3108,4807,9593
Quick Sort,193,1666,3066,4765,9497
Quick Sort,194,1815,3372,5248,10435
Quick Sort,195,1805,3346,5194,10345
Quick Sort,196,1849,3444,5368,10661
Quick Sort,197,1585,2914,4536,9035
Quick Sort,198,1664,3062,4772,9498
Quick Sort,199,1630,3008,4729,9367
Quick Sort,200,1646,3032,4759,9437
Quick Sort,201,2018,3778,5887,11683
Quick Sort,202,1711,3148,4894,9753
Quick Sort,203,1651,3030,4727,9408
Quick Sort,204,1709,3144,4925,9778
Quick Sort,205,1818,3368,5257,10443
Quick Sort,206,2030,3786,5923,11739
Quick Sort,207,2010,3740,5821,11571
Quick Sort,208,1820,3368,5252,10440
Quick Sort,209,1748,3226,4999,9973
Quick Sort,210,1866,3444,5389,10699
Quick Sort,211,1878,3466,5401,10745
Quick Sort,212,1816,3362,5245,10423
Quick Sort,213,1912,3538,5497,10947
Quick Sort,214,1697,3116,4888,9701
Quick Sort,215,2323,4358,6754,13435
Quick Sort,216,1940,3586,5587,11113
Quick Sort,217,2170,4044,6265,12479
Quick Sort,218,1933,3576,5560,11069
Quick Sort,219,1993,3696,5752,11441
Quick Sort,220,1836,3376,5263,10475
Quick Sort,221,2085,3886,6052,12023
Quick Sort,222,2267,4234,6586,13087
Quick Sort,223,1998,3702,5773,11473
Quick Sort,224,2005,3712,5800,11517
Quick Sort,225,2280,4264,6619,13163
Quick Sort,226,2042,3786,5911,11739
Quick Sort,227,2155,4004,6220,12379
Quick Sort,228,1998,3692,5786,11476
Quick Sort,229,1972,3644,5677,11293
Quick Sort,230,2229,4144,6466,12839
Quick Sort,231,2225,4150,6472,12847
Quick Sort,232,2180,4040,6313,12533
Quick Sort,233,2341,4376,6790,13507
Quick Sort,234,2023,3740,5860,11623
Quick Sort,235,2383,4456,6892,13731
Quick Sort,236,2128,3944,6115,12187
Quick Sort,237,2129,3940,6136,12205
Quick Sort,238,2174,4038,6290,12502
Quick Sort,239,2304,4290,6728,13322
Quick Sort,240,2163,3996,6226,12385
Quick Sort,241,2392,4462,6937,13791
Quick Sort,242,2235,4146,6437,12818
Quick Sort,243,2159,3982,6202,12343
Quick Sort,244,2442,4564,7076,14082
Quick Sort,245,2238,4158,6493,12889
Quick Sort,246,2281,4238,6592,13111
Quick Sort,247,2255,4190,6550,12995
Quick Sort,248,2219,4116,6413,12748
Quick Sort,249,2292,4240,6614,13146
Quick Sort,250,2523,4712,7318,14553
Quick Sort,251,2457,4580,7114,14151
Quick Sort,252,2484,4634,7207,14325
Quick Sort,253,2289,4254,6610,13153
Quick Sort,254,2237,4136,6466,12839
Quick Sort,255,2186,4042,6332,12560
Quick Sort,256,2260,4190,6505,12955
Quick Sort,257,2425,4512,7030,13967
Quick Sort,258,2758,5172,7987,15917
Quick Sort,259,2299,4254,6640,13193
Quick Sort,260,2832,5308,8215,16355
Quick Sort,261,2601,4852,7522,14975
Quick Sort,262,2325,4304,6737,13366
Quick Sort,263,2354,4364,6829,13547
Quick Sort,264,2628,4898,7615,15141
Quick Sort,265,2779,5200,8062,16041
Quick Sort,266,2535,4714,7318,14567
Quick Sort,267,2491,4622,7198,14311
Quick Sort,268,2919,5484,8506,16909
Quick Sort,269,2715,5064,7882,15661
Quick Sort,270,2500,4654,7279,14433
Quick Sort,271,2638,4910,7670,15218
Quick Sort,272,2523,4678,7288,14489
Quick Sort,273,2450,4540,7069,14059
Quick Sort,274,2727,5074,7942,15743
Quick Sort,275,2690,5016,7801,15507
Quick Sort,276,2461,4552,7049,14062
Quick Sort,277,2824,5278,8186,16288
Quick Sort,278,2476,4582,7148,14206
Quick Sort,279,2558,4748,7399,14705
Quick Sort,280,3017,5678,8794,17489
Quick Sort,281,2735,5104,7924,15763
Quick Sort,282,2631,4890,7648,15169
Quick Sort,283,2778,5174,8041,15993
Quick Sort,284,2608,4838,7537,14983
Quick Sort,285,2746,5122,7957,15825
Quick Sort,286,2666,4958,7723,15347
Quick Sort,287,2585,4788,7444,14817
Quick Sort,288,2809,5238,8182,16229
Quick Sort,289,3075,5764,8922,17761
Quick Sort,290,3029,5684,8831,17544
Quick Sort,291,3047,5710,8878,17635
Quick Sort,292,2917,5444,8458,16819
Quick Sort,293,2689,4990,7786,15465
Quick Sort,294,2733,5074,7894,15701
Quick Sort,295,3144,5890,9121,18155
Quick Sort,296,2966,5524,8575,17065
Quick Sort,297,2789,5188,8099,16076
Quick Sort,298,2896,5408,8432,16736
Quick Sort,299,3279,6162,9574,19015
Quick Sort,300,2761,5118,7980,15859
